name		达人麻将
ID		242
SoftID		242
SoftVer		17062701
icon		drmj/game.ico
main		runtime/v1.0/gamepc.exe
workdir		drmj
max_users	2
min_users	2
table_w	164
table_h	152
table_data	drmj\\hall\\table.txt
seat	drmj\\hall\\seat.zpc
lock	drmj\\hall\\lock.bmp
normal	drmj\\hall\\normal.bmp
playing	drmj\\hall\\playing.bmp
mnormal	drmj\\hall\\m_normal.bmp
mplaying	drmj\\hall\\m_playing.bmp
mask	drmj\\hall\\mask.zpc
back	drmj\\hall\\back.bmp
logo	drmj\\hall\\logo.bmp
level	drmj\\hall\\level.txt
chatVoice	drmj\\hall\\ChatVoice.txt
chatScript	drmj\\hall\\chat.txt
dlgBack	game\\Data\\dlgGame.txt
frameBack	game\\Data\\frameBack.txt
leftBtn	game\\Data\\btn_left.zpc
rightBtn	game\\Data\\btn_right.zpc
userInfo	game\\Data\\UserInfo.zpc
shangLan	game\\Data\\ShangLan.zpc
xiaLan	game\\Data\\XiaLan.zpc
frameUser	game\\Data\\frameUser.txt
btnDaoju	game\\Data\\btn_goumai.zpc
btnJingbi	game\\Data\\btn_jingbi.zpc
btnYaoqing	game\\Data\\btn_yaoqing.zpc
btnSetup	game\\Data\\btn_setup.zpc
btnHall	game\\Data\\btn_hall.zpc
btnExit	game\\Data\\btn_exit.zpc
btnHelp	game\\Data\\btn_help.zpc

